OOOOOOOOOOOOOOOOOOOOOOOOOOOOOOOOOOOXXXXXXXXXXOOOOOO
OOOOOOOOOOOOOOOOOOOOOOOOOOOOOOOOOOXXXXXXXXXXOOOOOOO
OOOOOOOOOOOOOOOOOOOOOOOOOOOOOOOOOOXXXXXXXXXXOOOOOOO
OOOOOOOOOOOOOOXXXXXXXXXXOOOOOOOOOOOXXXXXOOOOOOOOOOO
OOOOOOOOOOOOOOOXXXXXXXXXXOOOOOOOOOOOOOOOOOOOOOOOOOE
OOOOOOOXXXXXOOOOOXXXXXOOOOOOOOXXXXXOOOOOOOOOOOOOOOO
OOOOOOXXXXXOOOOOXXXXXOOOOOOOOXXXXXOOOOOOOOOOOOOOOOO
OOOOOXXXXXOOOOOOOXXXXXOOOOOOXXXXXXXXXXOOOOOOOOOOOOO
OXXXXXXXXXXOOOOOOOOOOOOOOOOXXXXXXXXXXOOOOOOOOOOOOOO
OXXXXXXXXXXOOOOOOOOOOOOOOOOOOOOOOOOOOOOOOOOOOOOOOOO
OXXXXXXXXXXOOOOOOOOOXXXXXOOOOOOOOOOOOOOOOOOOOOOOOOO
OXXXXXXXXXXOOOOOOOOXXXXXXXXXXOOOOXXXXXOOOOOOOOOOOOO
OOOXXXXXOOOOOOOOOOOOXXXXXOOOOOOOOOXXXXXOOOOOOOOOOOO
OOOOXXXXXOOOOOOOOOOOOOOOOOOOOOOOOOXXXXXXXXXXOOOOOOO
OOOOOOOOOOOOOOOOOOOOOOOOOOOOOOOOOOOOOXXXXXXXXXXOOOO
OOOOOOOOOOOOOOOOOOOOOOOOOOOOOOOOOOOXXXXXXXXXXOOOOOO
OOOOOOOOXXXXXOOOOOOOOOOXXXXXXXXXXOOOOXXXXXXXXXXOOOO
OOOOOOOXXXXXXXXXXXXXOOOOXXXXXXXXXXOOOOOXXXXXOOOOOOO
OOOOOOOOXXXXXXXXXXXOOOOOOXXXXXXXXXXOOOOOOOOOOOOOOOO
OOOOOOOOXXXXXXXXXXXOOOOXXXXXXXXXXXXXXXOOOOOOOOOOOOO
OOOOOOOXXXXXXXXXXXXXOOOOOOOOOXXXXXOOOOOOOOOOOOOOOOO
OOOOOOOOXXXXXXXXXXOOOOOOOOOOXXXXXOOOOXXXXXXXXOOOOOO
SOOOOOOOOXXXXXOOOOOOOOOOOOOOOOXXXXOOOOOXXXXXXOOOOOO
OOOOOOOOOOOOOOOOOOOOOOXXXXXOOOOOOOOOOOOOOOXXXXXOOOO
OOOOOOOOOOOOOOOOOOOOOXXXXXXXXXXOOOOOOOOOOOOOXXOOOOO
OOOOOOOOOOOOOOOOOOOOOOOOXXXXXOOOOOOOOOOOOOOOOOOOOOO
OOOOOOOOOOOOOOOOOOOOOOOXXXXXXXXXXOOOOOOOOOOOOOOOOOO
OOOOOOOOOOOOOOOOOOOOXXXXXXXXXXXXXXXOOOOOOOOOOOOOOOO